0,1,1,1,1,1,1,1,1,1,1,
1,1,0,0,0,0,0,0,0,0,1,
1,3,0,2,6,0,0,1,2,0,1,
1,0,2,6,2,2,1,1,0,0,1,
1,1,0,2,0,0,1,1,0,0,1,
1,0,2,0,1,1,7,1,5,0,1,
1,0,0,4,0,0,0,1,1,1,1,
1,1,1,1,1,1,1,1,0,0,0,
