1,1,1,1,1,1,1,1,1,0,0,
1,0,3,6,6,0,6,0,1,0,0,
1,0,1,0,1,0,1,6,1,0,0,
1,0,6,0,6,6,6,0,1,1,1,
1,2,1,2,1,6,1,0,1,7,1,
1,6,0,6,0,0,6,0,4,0,1,
1,0,1,0,1,0,1,5,1,1,1,
1,1,1,1,1,1,1,1,1,1,1,
