1,1,1,1,0,1,1,1,1,1,1,
1,7,0,1,1,1,2,0,2,3,1,
1,0,2,4,0,0,0,2,0,0,1,
1,2,0,2,1,2,1,0,2,1,1,
1,0,2,0,1,6,2,0,0,0,1,
1,2,0,2,1,0,1,2,1,0,1,
1,0,0,0,0,5,0,0,0,0,1,
1,1,1,1,1,1,1,1,1,1,1,
