0,0,0,0,0,1,1,1,1,1,1,
0,0,0,0,0,1,0,1,1,7,1,
0,0,0,1,1,1,0,3,2,0,1,
0,1,1,1,0,0,2,0,4,0,1,
0,1,0,2,0,0,2,2,1,1,1,
0,1,5,2,0,2,1,6,1,1,0,
0,1,0,2,6,0,6,0,0,1,0,
0,1,1,1,1,1,1,1,1,1,0,
