0,0,0,0,0,1,1,1,1,0,0,
0,0,1,1,1,1,0,5,1,0,0,
0,1,1,0,2,0,0,0,1,0,0,
1,1,0,0,0,2,0,1,1,1,0,
1,0,2,4,1,1,1,1,7,1,0,
1,6,0,2,0,0,2,0,0,1,0,
1,3,2,0,0,2,0,0,6,1,0,
1,1,1,1,1,1,1,1,1,1,0,
