1,1,1,1,1,1,1,0,0,0,0,
1,0,6,0,3,0,1,0,0,0,0,
1,6,1,1,2,0,1,1,1,1,1,
1,0,1,0,0,1,1,1,1,7,1,
1,6,0,2,0,0,2,0,0,0,1,
1,1,1,0,0,2,2,4,0,1,1,
1,1,1,0,5,0,2,0,1,1,0,
1,1,1,1,1,1,1,1,1,0,0,
